########################################
#                                      #
#                                      #
#                 #                    #
#                 #                    #
#                 #                    #
#                 #                    #
#                 #                    #
#                                      #
#                                      #
########################################